10000000000000000000000000000000000000000000001
10000000000000000000000000000000000000000000001
10000000000000000000000000000000000000000000001
10000000000000000000000000000000000000000000001
10000000000000000000000000000000000000000000001
10000000000000000000000000000000000000000000001
10000000000000000000000000000000000000000000001
11111111111111111111111111111111111111111111111
10000000000000000000000000000000000000000000001
10000000000000000000000000000000000000000000001
10000000000000000000000000000000000000000000001
10000000000000000000000000000000000000000000001
10000000000000000000000000000000000000000000001
10000000000000000000000000000000000000000000001
10000000000000000000000000000000000000000000001
10000000000000000000000000000000000000000000001
11111100000000000000000000000000000000000111111
10000110000000022200002220000222000000001100001
10000000000000000000021112000000000020000000001
10000000000000000022211111222000000000000000021
100222222222222222111111111112222222222222222112222222222
100100000000000000000000000000000000000000000000000000001
100100111000000000000000000000000000000000000000000000000
100100001000000000000000000000000000000000000000000000000
10010000100000000000000000000000000000000000011111111111111111111111111111
10011100100000000000000000000000000000000000010000000000000000000000000001
10010000100000000000000000000000000000000000010000000000000000000000000001
10010000100000000000000000000000000000000000010000000000000000000000000221
10010000111111111111111111111111111111111111110000000000000000000000000111
10011001111111111111111111111111111111000000000000000000000000000022000111
10000000000000000000011111111111111111000000000000000000000222000000000111
10000000000000000000011111000000000111000000000002200000000000000000000111
10000110000000000000000000000000000111000002220000000000000000000000000111
10000000000000000000000000000000000111000000110000000000000000000000000111
10000000000000000000022222000022000111000000112222222222222222222222222111
10000000000000000000010001000000000111001000110000000000000000000000000001
10000000000000000000010001002000000000000000000000000000000000000000000001
12222222222222222222210001000000000000000000000000000000000000000000000001
10000000000000000000000001000000000222200000220000000000000000000000000001
10000000000000000000000001222222222111000000110000000000000000000000000001
1000000000000000000000000000000000000100000011222222222222222222222222222111111111111111111111111111111111111111111111
1000000000000000000000000000000000000100000011000000000000000000000000001100000000000000000000000000000000000000000001
1000000000000000000000000000000000000111001111000000000000000000000000000000000000000000000000000000000000000000000001
1000000000000000000000000000000000000001001111000000000000000000000000000000000000000000000000000000000000022222222221
10000000000000000000000000000000000000010000000000000000002220000000200111220000000000000000000022200022000111
10000000000000000000000000000000000000010000000000000220000000002200000111000000000000000002200000000000002111
10000000000000000000000000000000000000010000002220000000000000000000000111000000000002200000000000000000001111
10000000000000000000000000000000000000011000000000000000000000000000000111000000000200000000000000000000021111
10000000000000000000000000000000000000011000000000000000000000000000000111000002200000000000000000000000011111
10000000000001111111111111111111111111111222222222222222222222222222222111200000000000000000000000000000211111
00000000000001000000000000000000000000000000000000000000000000001000000000000000000000000000000000000000111111
00000000000001000000000000000000000000000000000000000000000000001000000000000000000000000000000000000002111111
00000000000001000000000000000000000000000000000000000001200000001000000000000000000000000000000000000001111111
00000000000001000000000000000000000000000000000000000001000000001000000002222222222222222222222222222222111111
00000000000001000000000000000000000000000000000000000001000220001000000001
00000000000001000100000000000000000000000000000000000001000000001000000001
00000000000001000100000000000000222222222222222222222221000000001000000001
00000000000001000100000000000000100000000000000000000000000222221000000011
00000000000001000122222000000000100000000000000000000000000000001000000011
00000000000001000100001222222222100020000000000000000000000000001000000011
00000000000001000100001111111111120012222000000000000002200000001000000011
00000000000001000101001111111111100011111222000000000000000000001000000111
00000000000001000101000000000000000010000001222222222222222222221000000111
00000000111111000101000000000000002210000000000000000000000000000000000111
00000000100000000101000000000000000000000000000000000000000000000000000111
00000000100000000001000000000000000000000002000000000000000000000000001111
00000000122222222221222222222222222222222221222222222222222222222222221111